END:	login

#	============================================================
#	ARCOR LANGUAGE FILE
#	German
#	============================================================



KEY: arcor-de
TestString4: provider
NavMainEntryOverview: Startseite
NavMainEntryInternet: Daten
NavTabEntryDynDns: DNS / DDNS
NavTabEntryQosConfiguration: QoS-Einstellungen
NavMainEntryTelephony: Sprache
NavTabEntryLastCalls: Status
NavSubEntryTelephonyCommon: Erweiterte Einstellungen
NavSubEntryPhoneDevices: Rufnummernzuordnung
NavSubEntryCharacteristics: Telefoneinstellungen
NavSubEntryOutgoing: Ausgehende Anrufe
NavSubEntryIncoming: Eingehende Anrufe
NavTabStatistics: NAT Mapping Table
NavTabEntryWlanMode: Einstellungen
NavTabEntryWlanEncryption: Verschlüsselung
NavTabEntryWlanConfig: � Access Control
NavTabEntryWlanRepeaterMode: � WDS
NavTabEntryUsbDevices: � FTP-Server
NavTabEntryUsbPrinter: � Drucker-Server
NavTabEntryUsbAuthorisation: � Dateiserver
NavSubEntryExtDevices: � Web FTP Server
NavSubEntryMacFilter: � MAC Filtertabelle
NavSubEntryInternetPortMapping: � Port Mapping
NavSubEntrySecurityConfig: FIREWALL
NavSubEntryPacketFilter: � Address Mapping
NavTabEntryUrlFilter: � URL Blocking
NavSubEntryDMZ: � DMZ
NavMainEntrySystem: Extras
NavSubEntryTime: Zeiteinstellungen
NavSubEntryAccessConfig: � Zugangskontrolle
NavSubEntryAccessProtection: Anmeldeeinstellungen
NavSubEntryRemoteConfig: Fernwartung
NavSubEntryReset: Neustart
NavSubEntryUpdate: Firmwareaktualisierung
NavTabEntryInfoDsl: ADSL-Status
NavSubEntryDiagnostic: Diagnoseprogramm
NavMainEntryWizard: Wizard
ButtonRestart: Neustart
OverviewWizard: Willkommen bei Ihrer DSL-EasyBox 802
OverviewWizardIndex: Verwenden Sie den Installationsassistenten f�r die einfache und schnelle Konfiguration der DSL-EasyBox. Er wird Sie Schritt f�r Schritt durch das Installationsprogramm f�hren.
OverviewWizardEthEstablished: Ethernet: Verbindung hergestellt
OverviewWizardEthDisconn: Ethernet: Nicht verbunden
OverviewWizardAdslConn: ADSL: Leitung verbunden
OverviewWizardAdslDisconn: ADSL: Leitung nicht verbunden
OverviewWizardAdslEstablished: ADSL: Verbindung hergestellt
ExHspaNowConnected: Das Ger�t ist nun mit dem Internet verbunden.
ExLoginOldPassword: Altes Kennwort
ExLoginNewPassword: Neues Kennwort
ExLoginConfirmPassword: Neues Kennwort erneut eingeben
DataDNSIndex: DNS
DataPrimaryDNS: Prim�re DNS-Adresse
DataSecondaryDNS: Sekund�re DNS-Adresse (optional)
DataDDNSIndex: DynDNS-Einstellungen (Dynamic Domain Name Service)
DataDDNS: Dynamic DNS
DataDdnsServiceProvider: Diensteanbieter
DataDdnsDomainName: Dom�nenname
DataDdnsUsername: Konto / E-Mail
DataDdnsPassword: Passwort / Schl�ssel
ExHspaConfirmUMTS: Best�tigung Abfragen bei Verbindungsaufbau �ber Mobilfunknetz
WizardMainEntrySummary: �bersicht Ihrer Internetzugangsdaten
CommonNumber: Nr.
CommonSetting: Einstellen
CommonTelNumber: Telefonnummer
DataAdvancedSettings: Erweiterte Einstellungen
DataAllways: Immer
DataApp: Anwendung
DataApps: Anwendungen
DataAudioVideo: Audio/Video
DataBlock: Blockieren
DataClientIp: Client IP-Adresse
DataConfigure: Konfigurieren
DataCopy: Kopieren
DataFirewallAim: AIM
DataFirewallAllTcpPorts: Alle TCP Ports
DataFirewallAllUdpPorts: Alle UDP Ports
DataFirewallAlwaysBlock: Immer blockieren
DataFirewallClientIpRange: IP-Adresse des Clients
DataFirewallClientServices: Dienste des Clients
DataFirewallConnectionRules: Verbindungsregeln
DataFirewallCreateScheduleRule: Terminplanregel erstellen
DataFirewallDescOfClient: Bezeichnung des Clients
DataFirewallDetailsDesc: Detail-Beschreibung
DataFirewallDhcpClients: Liste der DHCP Clients
DataFirewallDmz: DMZ (Demilitarisierte Zone)
DataFirewallDmzEnable: Einschalten der DMZ Funktionen
DataDDNSIndexDesc1: DynDNS stellt dem Internetnutzer eine Methode zur Verf�gung, seine(n) Dom�nennamen mit Computern oder Servern zu verbinden. DynDNS stellt sicher, dass sich der Dom�nenname automatisch der IP-Adresse anpasst, indem sich Ihr DNS-Eintrag �ndert, wann immer sich Ihre IP-Adresse �ndert.
DataDDNSIndexDesc2: Dieses Leistungsmerkmal wird durch einen externen Dienstleister bereitgestellt. Mit einer DynDNS-Verbindung k�nnen Sie trotz einer dynamischen IP-Adresse lokal eine eigene Webseite, einen E-Mail-Server, einen FTP-Server und anderes mehr betreiben.
DataDNSIndexDesc: Ein Domain Name Server (DNS) ist ein Verzeichnis von IP- und Web-Adressen. Wenn Sie eine Web-Adresse in dieses Verzeichnis eingeben, findet der DNS-Server in seinem Verzeichnis diesen Namen und die dazu passende IP-Adresse. Aus Gr�nden von Schnelligkeit und Zweckm��igkeit stellen die meisten ISPs einen DNS-Server bereit. Da Sie durch Ihren ISP �ber dynamische IP-Einstellungen mit dem Internet verbunden werden, ist es wahrscheinlich, dass auch die IP-Adresse des DNS-Servers dynamisch vergeben wird. Sollten Sie einen anderen DNS-Server bevorzugen, m�ssen Sie dessen IP-Adresse hier eingeben.
DataDayOfWeek: Wochentag
DataDisabled: deaktiviert
DataEnabled: Aktiviert
DataEndtime: Ende-Zeit (hh:mm)
DataFirewall: Sicherheitseinstellungen (Firewall)
DataFirewallAccessControl: Zugangskontrolle
DataFirewallAccessControlForClients: Zugangskontrolle f�r angeschlossene PCs (Clients)
DataFirewallAccessControlIndex: Mit Hilfe der Zugangskontrolle k�nnen Sie bestimmen, welche Art von Datenverkehr zum Internet erlaubt ist. Diese Seite beinhaltet das Filtern von IP- und MAC-Adressen.
DataFirewallAccessControllIndex1: Auf dieser Seite k�nnen Sie Einstellungen von Clients, wie IP-Adresse, Art des Dienstes sowie Kriterien f�r Terminpl�ne festlegen.
DataFirewallAccessControllIndex2: Bez�glich der Blockierung von Web-Seiten (URL Blocking) ist es erforderlich, die entsprechende Internetadresse zuerst auf der Seite "URL Blocking" festzulegen. Gleiches gilt f�r die Eingabe von Terminpl�nen. Auch diese m�ssen Sie zuerst auf der Seite "Regeln f�r Terminpl�ne" konfigurieren.
DataFirewallDmzIndex1: Sollte ein Client hinter einer Firewall bestimmte Internetanwendungen nicht ordnungsgem�� ausf�hren k�nnen, kann man diesem Rechner durch Einrichten eines virtuellen DMZ Host den unbeschr�nkten, bidirektionalen Zugang zum Internet �ffnen.
DataFirewallDmzIndex2: Es k�nnen auch mehrere PCs f�r den bidirektionalen Zugang zum Internet f�r z.B. Internetspiele, Videokonferenzen oder VPN-Verbindungen freigeschaltet werden. Um die DMZ zu nutzen, mu� dem betreffenden PC eine feste IP-Adresse zugewiesen werden.
DataFirewallDns: DNS
DataFirewallDosCharacteristics: DoS Erkennungskriterien
DataFirewallEditScheduleRule: Terminplanregel bearbeiten
DataFirewallEmailAddress: Ihre E-mail Adresse
DataFirewallEmailAlert: Sollten Hacker versuchen in Ihr Netzwerk einzudringen, kann Sie die DSL-EasyBox per E-Mail alarmieren
DataFirewallEnable: Einschalten der Firewall-Funktionen
DataFirewallEnableFilter: Einschalten der Filterfunktion
DataFirewallFin: TCP FIN wait
DataFirewallFloddingBlockTime: Flooding cracker block time
DataFirewallFragHalfOpen: Fragmentation half-open wait
DataFirewallH323: H.323 Service
DataFirewallH323120: H.323, TCP Port 1720, 1503
DataFirewallH323DataChannelIdle: H.323 data channel idle timeout
DataFirewallHalfOpenFragSensitive: Half-open fragmentation detect sensitive time period
DataFirewallHttps: HTTPS
DataFirewallIndex: Die DSL-EasyBox bietet Ihnen umfassenden Schutz durch eine Firewall, �ber die der Internetzugriff zur Begrenzung des Risikos von Hackerangriffen und zur Abwehr eines gro�en Bereichs herk�mmlicher heimt�ckischer Angriffe von au�en beschr�nkt werden kann. Ist der uneingeschr�nkte Internetzugang unabdingbar, k�nnen Sie einen Server- oder Client als sog. demilitarisierte Zone (DMZ) konfigurieren.
DataFirewallIntrusionDetection: Festellen von unberechtigten Eindringversuchen (Intrusion Detection)
DataFirewallIntrusionDetection2: Feststellen von Eindringversuchen (Intrusion Detection Feature)
DataFirewallIntrusionDetectionIndex: Ist die SPI (Stateful Packet Inspection)-Firewall aktiv, k�nnen alle Datenpakete blockiert werden. Stateful Packet Inspection gestattet die Unterst�tzung unterschiedlicher Anwendungen, die dynamische Ports verwenden. F�r die in der nachstehenden Liste markierten Anwendungen l��t das Ger�t die vom lokalen LAN initiierten Datenpakete passieren. Das Ger�t kann herk�mmliche Hackerangriffe, wie IP-Spoofing, Land Attack, Ping of Death, IP with Zero length, Smurf Attack, UDP port loopback, Snork Attack, TCP null scan und TCP SYN flooding erkennen und blockieren.
DataFirewallIpAddressOfClient: IP-Adresse des Clients
DataFirewallL2tp: L2TP
DataFirewallMacFilter: MAC Filtertabelle
DataFirewallMacFilterControl: Kontrolle der MAC-Adressen
DataFirewallMacFilterIndex: Dieser Abschnitt hilft Ihnen bei der Konfiguration des MAC-Filters. Wenn aktiviert, haben nur noch die festgelegten MAC-Adressen Zugang zum Netzwerk. Allen anderen Rechnern wird der Zugang verwehrt. Diese Sicherheitsfunktion unterst�tzt bis zu 32 Clients.
DataFirewallMacFilterTable: MAC-Filtertabelle (bis zu 32 Eintr�ge)
DataFirewallMaxHalfOpenFragPacket: Maximum half-open fragmentation packet number from same host
DataFirewallMsn: MSN Messenger
DataFirewallNetMeeting: NetMeeting
DataFirewallNews: News Forums
DataFirewallPacketFrag: Packet Fragmentation
DataFirewallPingToWan: Discard Ping To WAN Interface
DataFirewallPop3ServerAddress: POP3 Server Adresse
DataFirewallPortRange: Port-Bereich (a-b, c, ..., x-y, z)
DataFirewallPptp: PPTP
DataFirewallReceiveEmail: E-mail empfangen
DataFirewallRip: RIP defect
DataFirewallRuleScheduler: Folgender Regel des Terminplans zuordnen
DataFirewallSPI: Stateful Packet Inspection
DataFirewallScheduleRule: Regeln f�r Terminpl�ne
DataFirewallScheduleRuleIndex: Auf dieser Seite werden die Namen f�r Terminpl�ne festgelegt und der Terminplan f�r die Verwendung auf der Seite "Zugangskontrolle" aktiviert.
DataFirewallScheduleRuleName: Name der Regel
DataFirewallScheduleRuleNotes: Anmerkungen zur Regel
DataFirewallScheduleRuleTable: Tabelle der Terminpl�ne (bis zu 10 Regeln)
DataFirewallScheduleTable: Tabelle der Terminpl�ne (bis zu 10 Regeln)
DataFirewallScheduler: Terminplan
DataFirewallSendEmail: E-mail senden
DataFirewallServiceDesc: Dienstebezeichnung
DataFirewallSmtpServerAddress: SMTP Server Adresse
DataFirewallSnmp: SNMP
DataFirewallSpiAndDos: SPI and Anti-DoS firewall protection
DataFirewallTcp110: POP3, TCP Port 110
DataFirewallTcp119: NNTP, TCP Port 119
DataFirewallTcp1723: TCP Port 1723
DataFirewallTcp21: FTP, TCP Port 21
DataFirewallTcp23: TCP Port 23
DataFirewallTcp25: SMTP, TCP Port 25
DataFirewallTcp443: HTTPS, TCP Port 443
DataFirewallTcp80: HTTP, TCP Port 80, 3128, 8000, 8001, 8080
DataFirewallTcpBlock80: HTTP (Ref. URL Blocking Site Page)
DataFirewallTcpConnIdle: TCP connection idle timeout
DataFirewallTcpSyn: TCP SYN wait
DataFirewallTcpUdpSessionsFromSameHost: Maximum incomplete TCP/UDP sessions number from same host
DataFirewallTcpUdpSessionsHigh: Total incomplete TCP/UDP sessions HIGH
DataFirewallTcpUdpSessionsLow: Total incomplete TCP/UDP sessions LOW
DataFirewallTcpUdpSessionsPerMinHigh: Incomplete TCP/UDP sessions (per min) HIGH
DataFirewallTcpUdpSessionsPerMinLow: Incomplete TCP/UDP sessions (per min) LOW
DataFirewallTcpUdpSessionsSensitiveTimeout: Incomplete TCP/UDP sessions detect sensitive time period
DataFirewallTelnet: Telnet
DataFirewallTftp: TFTP Service
DataFirewallUdp161: UDP Port 161, 162
DataFirewallUdp1701: UDP Port 1701
DataFirewallUdp53: UDP Port 53
DataFirewallUdpSession: UDP Session
DataFirewallUdpSessionIdle: UDP session idle timeout
DataFirewallUrlBlocking: URL Blocking: Gesperrte Internetseiten und verbotene Schl�sselworte
DataFirewallUrlBlockingEntry: Eintrag
DataFirewallUrlBlockingIndex1: Sie k�nnen den Zugang zu speziellen Internetseiten f�r einen bestimmten PC sperren, indem Sie entweder die volle Internetadresse (URL) oder lediglich ein Schl�sselwort der Internetseite eingeben.
DataFirewallUrlBlockingIndex2: Zur Festlegung des betreffenden PCs gehen Sie bitte auf die Seite "Zugangskontrolle" zur�ck und markieren Sie das K�stchen "WWW mit URL Blockierung" in der Tabelle der Filterregeln.
DataFirewallUrlBlockingKeywords: URL / Schl�sselwort
DataFirewallUrlBlockingPage: Seite
DataFirewallUserDefinedServices: Nutzerdefinierte Dienste
DataFirewallWww: WWW
DataFirewallWwwBlock: WWW mit URL Blockierung
DataFriday: Freitag
DataFrom: von
DataFtp: FTP
DataFtpService: FTP Service
DataGames: Spiele
DataId: ID
DataIndexDesc: Die DSL-EasyBox unterst�tzt erweiterte Einrichtungsfunktionen wie: Stateful Packet Inspection, das Feststellen von Hackerangriffen, das Filtern von Dateninhalten, Zugangskontrolle, virtuelle DMZ-Hosts, virtuelle Server und das Filtern von Clients.
DataInvalidRule: Keine g�ltige Regel
DataIpAddress: IP-Adresse
DataKeepDefaults: Wir empfehlen, die Werkseinstellungen beizubehalten.
DataMacAddress: MAC-Adresse
DataMacAdress: Mac-Adresse
DataMilliSeconds: Millisek
DataMinutes: Minuten
DataMode: Modus
DataMonday: Montag
DataName: Name
DataNatAddrMapping: Verkn�pfen von Adressen (Address Mapping)
DataNatAddrMapping2: Adressenverkn�pfung (Address Mapping)
DataNatAddrMappingConnectToPublic: verbinden mit der �ffentlichen IP-Adresse
DataNatAddrMappingIndex: Network Address Translation (NAT) erm�glicht es, IP-Adressen, die in einem privaten lokalen Netzwerk benutzt werden, mit einer oder mehreren Adressen, die im �ffentlichen globalen Internet verwendet werden, zu verkn�pfen. Dieses Leistungsmerkmal beschr�nkt die Anzahl �ffentlicher IP-Adressen, die Sie von Ihrem ISP beziehen m��ten. Es dient gleichzeitig der Sicherheit, indem verhindert wird, dass lokale IP-Adressen nach au�en bekannt werden. Dabei k�nnen eine oder mehrere �ffentliche IP-Adressen mit einem Pool von lokalen Adressen verkn�pft werden.
DataNatIndex: Index
DataNatLanIp: LAN IP
DataNatLanPort: LAN Port
DataNatMappingIndex: Die NAT-Verkn�pfungstabelle zeigt die gegenw�rtigen NAT-Adressverkn�pfungen an.
DataNatMappingLocalIp: Lokale IP
DataNatMappingLocalPort: Lokaler Port
DataNatMappingPage: Seite
DataNatMappingPeerIp: Peer IP
DataNatMappingPeerPort: Peer Port
DataNatMappingPseudoIp: Pseudo IP
DataNatMappingPseudoPort: Pseudo Port
DataNatMappingTable: NAT Mapping Table (NAT-Verkn�pfungstabelle)
DataNatPortMapping: Port Mapping (Verkn�pfen von Ports)
DataNatPortMappingIndex1: Sie k�nnen die DSL-EasyBox als virtuellen Server konfigurieren, damit entfernte Benutzer, die �ber �ffentliche IP-Adressen, wie Web- oder FTP-Dienste, auf Ihr lokales Netzwerk zugreifen, automatisch an lokale Server umgeleitet werden, die mit privaten IP-Adressen konfiguriert sind. Das hei�t, je nach dem angeforderten Dienst (TCP oder UDP) leitet die DSL-EasyBox die externe Diensteanforderung an den entsprechenden Server um (der sich an einer anderen internen IP-Adresse befindet).
DataNatPortMappingIndex2: Diese Funktion unterst�tzt die Angabe von:Port-Bereichen, mehreren Ports oder eine Kombination aus beiden.
DataNatPortMappingIndex3: Zum Beispiel
DataNatPortMappingIndex4: Port-Bereich: z.B. 100-150
DataNatPortMappingIndex5: Mehrere Ports: z.B. 25,110,80
DataNatPortMappingIndex6: Kombination: z.B. 25-100,80
DataNatProtcolType: Protokolltyp
DataNatPublicPort: �ffentlicher Port
DataNatSettings: NAT Einstellungen
DataNatSettingsEnableNat: Einschalten der NAT-Funktion
DataNatSettingsIndex: Network Address Translation (NAT) erm�glicht einer Vielzahl von lokalen Nutzern �ber eine einzige oder mehrere �ffentliche IP-Adressen auf das Internet zuzugreifen. NAT kann aber auch Angriffe von Hackern verhindern, indem lokale Adressen mit �ffentlichen Adressen f�r Schl�sseldienste wie das Web oder FTP verkn�pft werden.
DataNatSpecialApps: Spezielle Anwendungen
DataNatSpecialAppsIndex1: Einige Anwendungen, wie Internetspiele, Videokonferenzen, Internettelefongespr�che usw. erfordern mehrere Verbindungen. Diese Anwendungen funktionieren nicht, wenn Network Address Translation (NAT) aktiviert ist.
DataNatSpecialAppsIndex2: Wenn Sie also Anwendungen ausf�hren m�ssen, die mehrere Verbindungen erfordern, geben Sie den Anschlu� (Port) an, der normalerweise einer Anwendung im Feld "Trigger Port" zugeordnet ist und w�hlen Sie als Protokolltyp TCP oder UDP aus.
DataNatSpecialAppsIndex3: Geben Sie anschlie�end die �ffentlichen Ports (Public Ports), die dem "Trigger Port" zugeordnet werden, ein. Dadurch werden diese f�r den eingehenden Datenverkehr ge�ffnet.
DataNatSpecialAppsIndex4: Hinweis: Der Adressbereich des "Trigger Ports" reicht von 1 bis 65535
DataNatSpecialAppsPublicPort: Public Port
DataNatSpecialAppsPublicType: Public Type
DataNatSpecialAppsTriggerPort: Trigger Port
DataNatSpecialAppsTriggerType: Trigger Type
DataNatTCPandUDP: TCP und UDP
DataNewSearch: Neue Suche
DataNo: Nein
DataNote: Anmerkung
DataNr: Nr.
DataNumber: Nr.
DataPPPoA: PPPoA
DataPPPoE: PPPoE
DataPassword: Kennwort
DataPasswordRepeat: Kennwort best�tigen
DataPleaseChoose: -- bitte ausw�hlen --
DataProtocol: Protokoll
DataPublicIp: �ffentliche IP-Adresse
DataRead: Lesen
DataReconnect: Neu verbinden
DataRefresh: Aktualisieren
DataSSID: SSID
DataSaturday: Samstag
DataSeconds: Sekunden
DataServer: Server
DataSession: session
DataSnmpCommunity: Community
DataSnmpCommunityAccess: Zugang
DataSnmpCommunityHeading: SNMP Community (Gemeinschaft)
DataSnmpCommunityIndex: Bezogen auf SNMP, wird mit "Community" eine Beziehung zwischen einem sog. "Agent" (Server oder Router) und einer Anzahl von SNMP-Managern (Computern im Netzwerk, die SNMP-Dienste ausf�hren) zur �berwachung und Verwaltung eines Netzwerks bezeichnet. Das "Community"-Konzept arbeitet lokal und ist beim "Agent" definiert. Der "Agent" erstellt eine "Community" f�r jede gew�nschte Kombination von Authentifizierung, Zugangskontrolle und Proxy-Merkmalen her. Jeder "Community" innerhalb des "Agent" wird ein eindeutiger "Community"-Name zugewiesen. Die Managementstationen innerhalb dieser "Community" werden mit diesem Namen ausgestattet und m�ssen ihn bei allen "Get"-Anwendungen verwenden. Der "Agent" kann eine Anzahl von "Communities" mit �berlappenden Managementstationen bilden.
DataSnmpCommunityValid: G�ltig
DataSnmpEnable: Einschalten des SNMP Agent
DataSnmpHeading: SNMP (Simple Network Management Protocol) -Einstellungen
DataSnmpIndex: Das Ger�t stellt SNMP-Einstellungen f�r "Community"- (Gruppe von Hosts, die SNMP-Dienste ausf�hren) und "Trap"- (Befehl zum Abfragen au�ergew�hnlicher Ereignisse) Informationen bereit
DataSnmpTrapHeading: SNMP Trap (ein spezielles Kommando des Agent)
DataSnmpTrapIndex: Im Zusammenhang mit SNMP wird mit "Trap" ein Kommando bezeichnet, mit dem ein "Agent" unaufgefordert eine Nachricht an eine Managementstation senden kann. Sein Zweck ist es, die Managementstation �ber au�ergew�hnliche Ereignisse zu informieren.
DataSnmpTrapsEnable: Einschalten der SNMP Traps
DataSnmpv1: v1
DataSnmpv2c: v2c
DataStarttime: Start-Zeit (hh:mm)
DataSubnetmask: Subnetzmaske
DataSunday: Sonntag
DataTCP: TCP
DataThursday: Donnerstag
DataTimePeriod: Zeitspanne
DataTo: bis
DataToEntry: auf Eintrag
DataTuesday: Dienstag
DataUDP: UDP
DataUsername: Nutzername
DataVPN: VPN
DataVersion: Version
DataWan1483Bridging: 1483 Bridging
DataWan1483Routing: 1483 Routing
DataWan332: 3/32
DataWan3Minus: ---
DataWan4k4kTen: 4000/4000/10
DataWanATMPVC: ATM PVC
DataWanAlwaysConnected: Immer verbunden
DataWanAtmInterface: ATM Schnittstelle
DataWanAutoConnected: Auto - abh�ngig vom Datenverkehr
DataWanAvtivatePPPoEPassthrough: Aktivieren der PPPoE Durchlassfunktion
DataWanCBR: CBR
DataWanConnectionInterruption: Verbindungsunterbrechung von
DataWanConnectionInterruption2to5: Verbindungsunterbrechung von 02 bis 05 Uhr
DataWanConnectionInteruption24: Verbindungsunterbrechung gesteuert durch Internetdienstleister (alle 24 Stunden)
DataWanConnectionType: Art der Verbindung
DataWanDMACEncapsRouting: DMAC Encapsulated Routing
DataWanDesc: Beschreibung
DataWanEncaps: Encapsulation
DataWanIdleTime: Leerlaufzeit
DataWanIpByIsp: IP durch ISP zugewiesen
DataWanLLC: LLC
DataWanMTU: MTU
DataWanMinusSlashMinus: -/-
DataWanOverviewIndex: Die DSL-EasyBox verwendet ATM als Layer 2 Protokoll. ATM PVC ist eine virtuelle Verbindung, die als WAN-Schnittstelle fungiert. Die DSL-EasyBox unterst�tzt bis zu 3 ATM PVCs.
DataWanPCRSCRMBS: PCR/SCR/MBS
DataWanPPPoEPassthrough: PPPoE Durchlassfunktion
DataWanQoS: QoS-Klasse
DataWanTimeFromTo: %02d bis %02d Uhr
DataWanUBR: UBR
DataWanUBRPlus: UBR+
DataWanVBRNRT: VBR-nrt
DataWanVBRRT: VBR-rt
DataWanVC1: VC1
DataWanVC2: VC2
DataWanVC3: VC3
DataWanVCI: VCI
DataWanVCMUX: VC MUX
DataWanVPI: VPI
DataWanVPIVCI: VPI/VCI
DataWanWanInterface: WAN Schnittstelle
DataWednesday: Mittwoch
DataWireless: WLAN
DataWireless11b: 11b
DataWireless11bg: 11b/g
DataWireless11bgn: 11b/g/n
DataWireless11n: 11n
DataWirelessAccessControl: Zugangskontrolle der Funkteilnehmer �ber die MAC-Adresse
DataWirelessAccessControlEnableAccess: Einschalten der MAC-Filterfunktion
DataWirelessAccessControlEnter: Eintragen
DataWirelessAccessControlEnterAllClients: M�chten Sie alle gegenw�rtig angeschlossenen Funkteilnehmer mit ihrer jeweiligen MAC-Adresse eintragen?
DataWirelessAccessControlIndex: Zur Erh�hung der Sicherheit in einem Funknetzwerk k�nnen Sie festlegen, dass nur bestimmte Funkteilnehmer Zugang zur Basisstation (Access Point) erhalten. Bis zu 32 MAC-Adressen k�nnen in einer Filtertabelle eingetragen werden. Wenn aktiviert, werden alle registrierten MAC-Adressen �ber die Zugangsregel verwaltet.
DataWirelessAccessControlMacTable: MAC-Filtertabelle (bis zu 32 Eintr�ge)
DataWirelessAccessRule: Zugangsregel f�r registrierte MAC-Adressen
DataWirelessAllow: Zulassen
DataWirelessDeny: Zur�ckweisen
DataWirelessFunction: WLAN Funktion
DataWirelessHideSSID: SSID Ausstrahlung
DataWirelessIndex: Die DSL Easybox unterst�tzt den WLAN-N Standard mit bis zu 300 Mbit/s �bertragungsraten. Damit k�nnen PCs drahtlos per Funk mit der DSL-Easybox verbunden werden.
DataWirelessNameSSID: SSID (Name Funknetzwerk)
DataWirelessNetworkKey: Netzwerkschluessel
DataWirelessOff: Aus
DataWirelessOn: Ein
DataWirelessTimeControlled: Timer-gesteuert
DataWirelessWds: WDS (Wireless Distribution System)
DataWirelessWdsEnableWds: Einschalten der WDS Funktion
DataWirelessWdsIndex: Durch WDS haben Sie die M�glichkeit, die Reichweite Ihres Funknetzes zu erh�hen. WDS erm�glicht der Basisstation (Access Point) eine direkte Verbindung zu einer weiteren Basisstation (bzw. Repeater) aufzubauen und erlaubt damit den Funkteilnehmern, sich innerhalb des durch WDS erweiterten Bereiches zu bewegen.
DataWirelessWdsMacTable: Tabelle der MAC-Adressen der Basisstationen (bis zu 4 Basisstationen)
DataWrite: Schreiben
DataYes: Ja
ExAdslActRate: Aktuelle Daten-Rate
ExAdslAttenuation: D�mpfung
ExAdslConfigured: Konfiguriert
ExAdslCounter: Zell-Z�hler
ExAdslCrcError: CRC Fehler
ExAdslCurrent: Aktuell
ExAdslDownstream: Downstream
ExAdslErrorIndication: Fehlerindikatoren
ExAdslFarEndIndicator: Far-End-Indikator
ExAdslFastPath: Fast Path
ExAdslFecError: FEC Fehler
ExAdslHeading: Status�bersicht
ExAdslHecError: HEC Fehler
ExAdslKbps: (Kbps.)
ExAdslLineStatus: Leitungs-Status
ExAdslLinkType: Verbindungs-Typ
ExAdslNearEndIndicator: Near-End-Indikator
ExAdslNoiseMargin: Rausch-Abstand
ExAdslOperatingData: Betriebsdaten / Fehleranzeige
ExAdslReceived: Empfangene Zellen
ExAdslShowTime: SHOWTIME
ExAdslSpeed: �bertragungsgeschwindigkeit
ExAdslStandardAutomatic: Automatisch
ExAdslStandardHeading: ADSL Parameter
ExAdslStandardMode: Funktionsmodus
ExAdslStandardStandard: ADSL-Standard
ExAdslStandardText: Diese Seite erlaubt Ihnen, den zu nutzenden ADSL-Standard zu spezifizieren. Sie k�nnen explizit einen spezifischen Standard setzen, oder "Automatisch" w�hlen, um automatisch einen Standard mit dem Remote-DSLAM auszuhandeln.
ExAdslStatistics: Statistiken
ExAdslStatus: Status
ExAdslText: ADSL Status Information
ExAdslTransmitted: �bertragene Zellen
ExAdslUpstream: Upstream
ExCommonDirectory: Verzeichnis
ExCommonDisk: Laufwerk
ExCommonDiskSelect: -- Festplatte ausw�hlen --
ExCommonDrive: Datentr�ger
ExCommonHideAll: Verbergen
ExCommonManual: (manuelle Eingabe)
ExCommonMassStorage: Massenspeicher
ExCommonNoUsbDrive: Kein USB-Massenspeicher angeschlossen.
ExCommonNoUsbModem: Keinen USB-Modem gefunden.
ExCommonNoUsbPrinter: Keinen USB-Drucker gefunden.
ExCommonPartition: Partition
ExCommonPartitionSelect: -- Datentr�ger ausw�hlen --
ExCommonPasswordConfirmation: Kennwort best�tigen
ExCommonRemoteAccess: Fernzugriff
ExCommonRemove: Entfernen
ExCommonRetrain: Neu Lernen
ExCommonShowAll: Anzeigen
ExCommonSubdir: Unterverzeichnis
ExCommonVc: VC
ExCommonWan: WAN
ExDiagBegin: Beginn
ExDiagConnectionType: Verbindungsart
ExDiagDestination: Zieladresse
ExDiagEnd: Ende
ExDiagExecute: Ausf�hren
ExDiagHeading: Diagnoseprogramm
ExDiagMai: MAI
ExDiagModem: Modem
ExDiagPing: Ping-Test
ExDiagRecord: Aufzeichnen von WAN-Datenpaketen
ExDiagResult: Ergebnis
ExDiagSave: Speichern
ExDiagText: Mit diesem Programm k�nnen Sie den Status Ihrer Netzwerkverbindung pr�fen. F�r den Ping-Test k�nnen Sie als Zieladresse einen Dom�nennamen oder eine g�ltige IP-Adresse angeben.
ExDiagUplink: Ethernet Uplink
ExFirmwareLoadHeading: Wiederherstellen einer Konfiguration Ihrer DSL-EasyBox
ExFirmwareLoadRestore: Wiederherstellen einer gespeicherten Konfiguration
ExFirmwareLoadText: Geben Sie den Pfad oder den Namen der gespeicherten Sicherungsdatei ein und klicken Sie dann auf das Schaltfl�che "�bernehmen". Sie werden aufgefordert, die Wiederherstellung auf die gespeicherte Konfiguration zu best�tigen.
ExFirmwareLoadUsage: Wenn Sie einen neuen Modem-Installationscode, z.B. nach Umzug oder Technologiewechsel, erhalten haben, wird automatisch nur Ihre pers�nliche Konfiguration geladen. Ihre Zugangsdaten werden dann nicht �berschrieben.
ExFirmwareResetConfirmation: WARNUNG: Alle Einstellungen gehen unwiederbringlich verloren! Sind Sie sicher?
ExFirmwareResetHeading: Zur�cksetzen auf Werkseinstellungen
ExFirmwareResetReset: Zur�cksetzen
ExFirmwareResetText: Sie k�nnen Ihre DSL-EasyBox auf die Werkseinstellungen zur�cksetzen, indem Sie auf diese Schaltfl�che klicken. Bitte beachten Sie, dass dabei alle von Ihnen vorgenommenen Einstellungen verloren gehen!
ExFirmwareSaveHeading: Speichern der Konfiguration Ihrer DSL-EasyBox
ExFirmwareSaveSave: Speichern
ExFirmwareText: Wenn Sie auf die Schaltfl�che "Speichern" klicken, werden alle Einstellungen der DSL-EasyBox gesichert. Sie k�nnen anschlie�end den Speicherort dieser Sicherung frei w�hlen.
ExFirmwareUpgradeAltText: Alternativ k�nnen Sie auch lokal eine Firmware laden. Die aktuelleste Firmware finden sie auf
ExFirmwareUpgradeConfirmation: Das Ger�t wird neu gestartet und sucht dabei nach neuer Firmware. Wollen Sie fortfahren?
ExFirmwareUpgradeFile: Firmware-Datei
ExFirmwareUpgradeHeading: Firmwareaktualisierung
ExFirmwareUpgradeText: Sie k�nnen die Firmware Ihrer DSL-EasyBox automatisch �ber das Internet aktualieren. Eine bestehende Internet-Verbindung ist daf�r Vorraussetzung. Ihre Konfiguration bleibt beim Firmware-Upgrade erhalten.
ExFirmwareUpgradeText1: Sie k�nnen die Firmware Ihrer DSL-EasyBox �ber das Internet aktualisieren. Gehen Sie hierzu auf die Internetseite
ExFirmwareUpgradeText2: , w�hlen dort Ihr DSL-EasyBox Modell aus und laden die Datei mit der aktuellen Frimware herunter.
ExFirmwareUpgradeUsage: Geben Sie entweder den Pfad oder Namen ein oder benutzen Sie den Browser, um zur gew�nschten Firmware-Datei zu gelangen. Klicken Sie dann auf die Schaltfl�che "�bernehmen". Um den Aktualisierungsprozess abzuschlie�en werden Sie aufgefordert die Aktualisierung zu best�tigen.
ExHspaActRate: Act. Rate
ExHspaApn: APN
ExHspaBackupBoth: UMTS Backup f�r Daten&Sprache
ExHspaBackupConnection: Backup-Verbindung
ExHspaBackupData: UMTS Backup f�r Daten
ExHspaBackupOnly: Nur UMTS Verbindung
ExHspaBackupVoice: UMTS Backup f�r Sprache
ExHspaCode: -code (f�r SIM Karte)
ExHspaCodeInput1: Bitte geben Sie Ihren pers�nlichen
ExHspaCodeInput2: Code f�r die Mobilfunk SIM-Karte ein. Ihre Verbindung wird dann �ber Mobilfunk hergestellt, wenn keine Festnetz-Verbindung besteht.
ExHspaCompression: Bild-Kompression nutzen
ExHspaConfirmPassword: Kennwort best�tigen
ExHspaConfirmPin: Best�tigung
ExHspaConfirmUMTSRemark: Bitte best�tigen Sie, dass Sie die Internet-Verbindung �ber das Mobilfunknetz aufbauen m�chten. F�r diese Verbindung k�nnen zus�tzliche Kosten je nach Ihrem Mobilfunk-Tarif entstehen.
ExHspaConfirmation: Best�tigung abfragen bei Verbindungsaufbau �ber Mobilfunknetz
ExHspaConnectionOverUMTS: Internet Verbindung �ber UMTS verf�gbar
ExHspaDSLCurrNotAvailable: Ihre DSL Verbindung ist derzeit nicht verf�gbar.
ExHspaDSLNotAvailable: DSL nicht verf�gbar
ExHspaDeviceTryingConnect: Das Ger�t verbindet sich mit dem Internet.
ExHspaHeading: UMTS-Stick
ExHspaIdleTime: Leerlaufzeit (Minuten)
ExHspaMaxrate: Max Rate
ExHspaNetworkOperator: Netzwerk-Betreiber
ExHspaNewPin: Neuer PIN-code (f�r SIM Karte)
ExHspaNoBackup: Kein UMTS Backup
ExHspaNoStick: Kein UMTS-Stick angeschlossen!
ExHspaNotConnected: Nicht Verbunden
ExHspaPassword: Kennwort
ExHspaPhoneNumber: Telefonnummer
ExHspaPin: PIN Code (f�r SIM Karte)
ExHspaPinInput1: Bitte geben Sie Ihre
ExHspaPinInput2: ein.
ExHspaPinOk: PIN code ok.
ExHspaPleaseWait: Bitte warten.
ExHspaRemark: Hinweis
ExHspaRemoveStick: Bitte entfernen Sie den UMTS-Stick und pr�fen die SIM Karte.
ExHspaReopenInNewWindow: Sollten Sie nicht korrekt auf die angeforderte Web-Adresse weitergeleitet werden, so schlie�en Sie bitte das aktuelle Browserfenster und �ffnen ein neues Fenster.
ExHspaRescan: Neue Suche
ExHspaRoaming: Roaming
ExHspaSavePin: PIN Speichern
ExHspaSelect: Auswahl
ExHspaService: Service
ExHspaStatus: Status
ExHspaText: Die DSL-EasyBox bietet Ihnen in Verbindung mit einem UMTS-Stick die M�glichkeit eine Internet oder Sprachverbindung �ber das UMTS-Mobilfunknetz herzustellen. Bitte setzen Sie die SIM Karte in den UMTS-Stick, entfernen die Ger�tekappe auf der R�ckseite der DSL-EasyBox und stecken den UMTS-Stick in die darunterliegende Buchse. Danach geben Sie bitte den PIN Code Ihrer SIM Karte hier ein.
ExHspaUmtsConnection: UMTS-Verbindung
ExHspaUserName: Benutzername
ExHspaWarning: Achtung
ExHspaWarning1: Wenn diese Eingabe nicht korrekt erfolgt, wird Ihre SIM-Karte gesperrt.
ExHspaWarning2: Falscher
ExHspaWarning3: code
ExHspaWarning4: Noch
ExHspaWarning5: Eingabeversuche m�glich.
ExIndexHeading: Systemeinstellungen
ExIndexText: Hier finden Sie grundlegende Konfigurationswerkzeuge f�r die DSL-EasyBox wie Anmelde- und Zeiteinstellungen sowie Fernverwaltung.
ExLoginAdditionalText: Wenn Sie Ihre DSL-EasyBox von einem PC au�erhalb Ihres Netzwerks verwalten m�chten, m�ssen Sie auch die IP-Adresse dieses PCs eingeben. Sie k�nnen dies im Men� "Fernwartung" tun.
ExLoginHeading: Anmeldeeinstellungen
ExLoginLoginText: Anmeldebildschirm (Lassen Sie diese Tabelle leer, wenn nichts ver�ndert werden soll)
ExLoginNewName: Neuer Benutzername
ExLoginOldName: Alter Benutzername
ExLoginText: Geben Sie einen Benutzernamen und ein Kennwort ein, um den unbefugten Zugang auf Ihre DSL-EasyBox zu verhindern.
ExLoginTimeout: Abmeldung nach einer Wartezeit von
ExLoginTimeoutLabel: Minuten ("0" bedeutet keine Abmeldung)
ExLoginTimeoutText: Einstellungen zur Anmeldung
ExNcidActivate: Einschalten
ExNcidHeading: NCID
ExNcidHistory: Gespr�chs Historie
ExNcidPort: Port Nummer
ExNcidText: Network Caller ID Einstellungen
ExQosActivate: Einschalten der QoS-Funktion
ExQosAddrTypeDevice: Ger�t
ExQosAddrTypeDeviceDescr: lokal
ExQosAddrTypeDomain: Dom�nenname
ExQosAddrTypeDomainDescr: Dom�ne
ExQosAddrTypeIp: IP-Adresskreis
ExQosAddrTypeMac: MAC-Adresse
ExQosAddrTypeMacDescr: MAC-Adressen
ExQosAddrTypePorts: Eingehende Ports
ExQosAddrTypePortsDescr: LAN/WLAN
ExQosAddrTypeSubnet: IP-Subnetz
ExQosAny: Alle
ExQosBandwidth1: WAN Uplink Bandbreite
ExQosBandwidth2: kbps
ExQosBandwidth3: Bandbreite reserviert f�r die Sprachverbindung
ExQosBandwidth4: kbps
ExQosBandwidth5: (VC2 ist nicht aktiv)
ExQosBandwidth6: (VC2 PCR=
ExQosBandwidth7: Verwaltung der verbleibenden Bandbreite f�r die Internetverbindung
ExQosBestEffort: Weiterleitung nach jeweils bester M�glichkeit
ExQosDescription: Beschreibung
ExQosEditAdvanced: Erweitert
ExQosEditDscp: Verkn�pfen mit Weiterleitungsgruppe
ExQosEditDscpTos: DSCP/TOS
ExQosEditDscpTosWmm: DSCP/TOS/WMM
ExQosEditExample: (z.B. "abc.def.com;*.xyz.com")
ExQosEditHeading: Bearbeiten von Klassen f�r den Datenverkehr
ExQosEditLocalAddr: Lokale IP-Adresse
ExQosEditLocalPort: Lokaler Port
ExQosEditMarkDscp: Bezeichne DSCP als
ExQosEditName: Bezeichnung der Regel
ExQosEditNetmask: (IP-Subnetz/L�nge der Subnetzmaske)
ExQosEditNoRemark: Keine Anmerkung
ExQosEditOtherTos: Anderer TOS
ExQosEditRemoteAddr: Remote Adresse
ExQosEditRemotePort: Remote Port
ExQosEditRouting: per Routing
ExQosEditSpecialValue: Spezieller Wert
ExQosEditText: Auf dieser Seite k�nnen Sie eine Klassifizierungsregel erstellen. Bestimmen Sie dazu zuerst die Klasse aufgrund der Art des Datenverkehrs sowie lokale und ferne Adresse. Geben Sie dann die Diffserv-Weiterleitungsgruppe ein, mit der diese Klasse verkn�pft werden soll. Zuletzt w�hlen Sie die abgehende Verbindung (VC) aus, auf die diese Klasse weitergeleitet werden soll.
ExQosEditTrafficType: Art des Datenverkehrs
ExQosEditUseVc: Nutzung von VC
ExQosEditUseWan: Nutzung von WAN
ExQosEditWmmAcs: WMM ACs
ExQosFastest: Durch die Express-Weiterleitung erhalten Sie die kleinste Verz�gerung, die geringsten Schwankungen und den kleinstm�glichen �bertragungsverlust an Datenpaketen.
ExQosHeading: QoS-Einstellungen
ExQosHigh: Hoch
ExQosHighest: H�chste
ExQosLow: Gering
ExQosLowest: Geringste
ExQosMedium: Zugesicherte Weiterleitung erm�glicht die �bermittlung von vier voneinander unabh�ngigen Klassen. Innerhalb einer Klasse kann ein IP-Paket eine von drei verschiedenen Priorit�tsstufen zugesichert werden.
ExQosMin: Minimum
ExQosMore: Mehr erlauben
ExQosName: Name
ExQosOr: oder
ExQosPlanAssignment: Zuordnung zu Diffserv
ExQosPlanConfigure: Konfigurieren
ExQosPlanDescription: Beschreibung des Datenverkehrs
ExQosPlanHeading: Datenverkehr zuordnen
ExQosPlanName: Name der Regel
ExQosPlanNoAssignment: Es wurde keine Zuweisung des Datenverkehrs vorgenommen. Aus diesem Grund wird aller Datenverkehr nach der Regel BE (Best Effort) behandelt.
ExQosPlanText: Es k�nnen bis zu 16 Regeln aufgestellt werden, um den Internetverkehr in Diffserv-�bertragungsgruppen zu klassifizieren.
ExQosPlanVc: genutzter VC
ExQosPlanWan: genutzter WAN
ExQosPriority: Priorit�t
ExQosReservedBandwidth: Reservierte Bandbreite
ExQosStatistics12Hours: 12 Stunden
ExQosStatistics1Hour: 1 Stunde
ExQosStatistics5Min: 5 Minuten
ExQosStatistics6Hours: 6 Stunden
ExQosStatisticsHeading: Statistiken zum Datenverkehr
ExQosStatisticsRate: Durchschnittliche Rate der verlorenen Pakete in Byte pro Sekunde
ExQosStatisticsText: Diese Seite zeigt eine Statistik des Datenverkehrs der Diffserv-Weiterleitungsgruppen f�r die letzten 12 Stunden an (wird automatisch alle 5 Minuten aktualisiert).
ExQosStatisticsTraffic: Durchschnittliche �bertragungsrate in Byte pro Sekunde
ExQosStatisticsType: Art der Weiterleitung
ExQosText: Der Bandbreitenunterschied zwischen LAN und WAN kann die �bertragungsqualit�t kritischer Netzwerkanwendungen wie Sprache, Spiele oder VPN deutlich herabsetzen. Mit der QoS-Funktion k�nnen Sie den Datenverkehr dieser Anwendungen klassifizieren und �bertragungsgeschwindigkeiten reservieren (Diffserv = differentiated services).
ExQosTfcTypeEmail: E-MAIL
ExQosTfcTypeFtp: FTP
ExQosTfcTypeIgmp: IGMP
ExQosTfcTypeIp: Benutzerdefiniert - IP
ExQosTfcTypeRtsp: RTSP
ExQosTfcTypeSnmp: SNMP
ExQosTfcTypeTcp: Benutzerdefiniert - TCP
ExQosTfcTypeTelnet: TELNET
ExQosTfcTypeUdp: Benutzerdefiniert - UDP
ExQosTfcTypeVoice: Sprache
ExQosTfcTypeVpn: VPN
ExQosTfcTypeWww: WWW
ExRebootConfirmation: M�chten Sie jetzt einen Neustart der DSL-EasyBox durchf�hren?
ExRebootHeading: Neustart
ExRebootReboot: Neustart
ExRebootText: Um einen Neustart durchzuf�hren, klicken Sie auf die Schaltfl�che "Neustart". Sie werden aufgefordert, diese Entscheidung zu best�tigen. Der Neustart ist abgeschlossen, wenn die "Power" LED wieder rot leuchtet . Ihre Einstellungen werden dadurch nicht ver�ndert.
ExRemoteActive: Aktiviert
ExRemoteAddress: Adresse des PCs
ExRemoteHeading: Fernverwaltung
ExRemotePort: Port Nummer
ExRemoteText: Auf dieser Seite stellen Sie die Fernverwaltung f�r die DSL-EasyBox ein. M�chten Sie die DSL-EasyBox von einem PC au�erhalb des lokalen Netzwerks verwalten k�nnen, m�ssen Sie auch die IP-Adresse dieses PCs eingeben.
ExTimeHeading: Zeiteinstellungen
ExTimeNtpHeading: Konfiguration des Zeitservers (NTP)
ExTimeNtpLabel: Einschalten der automatischen Einstellung durch einen Zeitserver
ExTimeNtpText: Sie k�nnen die Zeit der Systemuhr Ihrer DSL-EasyBox auch automatisch von einem Zeitserver im Internet einstellen lassen.
ExTimeText: Einstellen der Zeitzone
ExTimeTimezoneText: Verwenden Sie diese Einstellungen um sicherzustellen, dass zeitgesteuerte Filterfunktionen und Eintr�ge des Logbuchs Ihrer DSL-EasyBox auf der Basis einer korrekten, ortsbezogenen Uhrzeit vorgenommen werden.
ExUpnpActivate: Aktivieren von UPnP Statusinformationen
ExUpnpActivateAv: Aktivieren DLNA Medien-Server
ExUpnpActivateFull: Aktivieren aller UPnP Funktionen
ExUpnpActivateIgd: Aktivieren IGD-Ger�te
ExUpnpBrowseHeading: UPnP AV Medien-Server / Freigegebener Ordner
ExUpnpBrowseOf: / von
ExUpnpDirectory: Verzeichnis
ExUpnpEditCreate: Ordner anlegen, falls er nicht existiert
ExUpnpEditHeading: UPnP AV Medien-Server / Freigegebener Ordner
ExUpnpFolder1: Freigegebener Ordner (bis zu
ExUpnpFolder2: Ordner)
ExUpnpHeading: UPnP
ExUpnpMemory: Speicher Nutzung: 0%
ExUpnpReallyDelete: Sind Sie sicher, dass Sie diesen freigegebenen Ordner l�schen wollen?
ExUpnpReallyReload: Dies kann eine Weile dauern. Sind Sie sicher?
ExUpnpSetting: Einstellen
ExUpnpText: Die Universal Plug-and-Play-Software (UPnP) erkennt und integriert alle Arten von neuer Hardware, wie z. B. PCs und Wireless-Ger�te in einem Netzwerk. �ber UPnP k�nnen sich solche Ger�te nahtlos in ein Netzwerk einbinden. Nach Abschlu� der Integration k�nnen diese Ger�te gleichberechtigt im Netzwerk kommunizieren und Daten austauschen.
ExUpnpTitle: Titel
ExUsbAvtivate: USB Host Controller
ExUsbBoundTo: verbunden mit
ExUsbBrowseOf: / von
ExUsbCommonName: Name
ExUsbCommonPort: TCP-Port
ExUsbCommonSetting: Einstellen
ExUsbCommonUsage: Um auf die Inhalte Ihres USB-Massenspeichers aus dem Internet zugreifen zu k�nnen, schalten Sie die Funktion "Fernzugriff" ein. Auserhalb Ihres lokalen Netzwerkes m�ssen Sie dann die Ihnen zugeteilte "WAN IP"-Adresse eingeben. Diese finden Sie auf der Startseite Ihrer DSL-EasyBox (im Bereich "Internet").
ExUsbCommonUser: Benutzername
ExUsbEditAccess: Zugriff
ExUsbFileActivate: Dateiserver-Funktionen
ExUsbFileDescription: Beschreibung des Servers
ExUsbFileEditAccessProtection: Zugriffsschutz durch Passw�rter
ExUsbFileEditFolder: Freigegebener Ordner
ExUsbFileEditHeading: Dateiserver / Freigegebener Ordner
ExUsbFileEditPasswordAccess: Abh�ngig vom eingegebenen Kennwort
ExUsbFileEditReadAccess: Nur Lesezugriff
ExUsbFileEditReadPassword: Kennwort f�r Lesezugriff
ExUsbFileEditSecurity: Sicherheit
ExUsbFileEditWriteAccess: Vollzugriff
ExUsbFileEditWritePassword: Kennwort f�r Vollzugriff
ExUsbFileGroup: Gruppe
ExUsbFileHeading: Dateiserver
ExUsbFileIp: \\(IP-Adresse)
ExUsbFileIpDir: \\(IP-Adresse)\(Verzeichnis)
ExUsbFileIpDirExample: Bsp.: "\\192.168.2.1\partition1"
ExUsbFileIpExample: Bsp.: "\\192.168.2.1"
ExUsbFileResponse1: Freigegebener Ordner (bis zu
ExUsbFileResponse2: Ordner)
ExUsbFileServer: Server
ExUsbFileSrv: \\(Server)
ExUsbFileSrvDir: \\(Server)\(Verzeichnis)
ExUsbFileSrvDirExample: Bsp.: "\\EasyBox\partition1"
ExUsbFileSrvExample: Bsp.: "\\EasyBox"
ExUsbFileText: Auf dieser Seite k�nnen Sie den Dateiserver Ihrer DSL-EasyBox konfigurieren, um Dateien im Netzwerk einfach und bequem austauschen zu k�nnen. Voraussetzung f�r die Nutzung dieser Funktion ist der Einsatz von Windows� 95, 98, NT 4.0, 2000, XP oder anderen Betriebssystemen, die NetBIOS/SMB unterst�tzen. Nachdem Sie einen USB-Massenspeicher (Festplatte oder USB-Stick) an die USB-Schnittstelle angeschlossen haben w�hlen Sie die gew�nschten Verzeichnisse aus, die Sie zur gemeinsamen Nutzung freigeben wollen. Sie k�nnen den Zugriff auf diese Inhalte mit einem Benutzernamen und Passw�rtern f�r den Lese- bzw. Vollzugriff sch�tzen. Nachdem Sie die Freigaben eingerichtet und den Dateiserver eingeschaltet haben, k�nnen Sie auf diese zugreifen. Geben Sie in Ihrem Internet-Browser oder z.B. dem Windows Explorer hierzu Folgendes ein
ExUsbFtpActivate: FTP-Server Funktionen
ExUsbFtpEditHeading: FTP-Server / Benutzerprofile
ExUsbFtpEditPassword: Kennwort
ExUsbFtpEditReadAccess: Nur Lesen
ExUsbFtpEditWriteAccess: Vollzugriff
ExUsbFtpHeading: FTP-Server
ExUsbFtpIdleTime: Abmeldung nach einer Wartezeit von
ExUsbFtpIdleTimeLabel: Minuten ("0" bedeutet keine Abmeldung)
ExUsbFtpIp: ftp://(IP-Adresse)
ExUsbFtpIpExample: Bsp.: "ftp://192.168.2.1"
ExUsbFtpMaxConnections: Maximale Anzahl der Verbindungen
ExUsbFtpProfile1: Benutzerprofile (bis zu
ExUsbFtpProfile2: Profile)
ExUsbFtpText: Auf dieser Seite k�nnen Sie Ihre DSL-EasyBox als FTP-Server konfigurieren. Mit dieser Funktion k�nnen Sie den Zugriff auf Dateien, die sich auf Ihrem an der DSL-EasyBox angeschlossenen USB-Massenspeicher befinden, in Ihrem lokalen Netzwerk oder im Internet erm�glichen. Richten Sie zun�chst einzelne Benutzerprofile ein und w�hlen Sie die Verzeichnisse und Ordner aus, deren Inhalte Sie freigeben wollen. Sie k�nnen f�r jedes Nutzerprofil verschiedene Passw�rter und Verzeichnisse/Ordner festlegen. Nachdem Sie die Profile eingerichtet und den FTP-Server eingeschaltet haben, k�nnen Sie auf diese zugreifen. Geben Sie in Ihrem Internet-Browser oder z.B. dem Windows Explorer hierzu Folgendes ein
ExUsbHeading: USB
ExUsbModem: USB-Modem verbunden
ExUsbPartitions: Partitionen
ExUsbPrinter: USB-Drucker verbunden
ExUsbPrtActivate: LPD-LPR Drucker-Server
ExUsbPrtHeading: Drucker-Server
ExUsbPrtName: Name des Druckers (LPR Queue Name)
ExUsbPrtText: Ihr Ger�t verf�gt �ber einen Drucker-Server der es erm�glicht, Ihren an der DSL-EasyBox angeschlossenen USB-Drucker als Netzwerkdrucker zu nutzen. Hierzu m�ssen Sie auf jedem Computer, von dem aus Sie den Netzwerkdrucker nutzen wollen, einen Druckeranschluss einrichten. �ber den Druckeranschluss werden Druckauftr�ge an die IP-Adresse des Drucker-Servers im lokalen Netzwerk weitergeleitet. N�here Informationen erhalten Sie im Handbuch Ihrer DSL-EasyBox.
ExUsbRes1: USB-Massenspeicher: maximal
ExUsbRes2: Festplatte(n) oder
ExUsbRes3: Speicher-Stick(s)
ExUsbRes4: USB-Drucker: maximal
ExUsbRes5: USB-Drucker
ExUsbRes6: USB-Hubs: maximal 1 USB-Hub
ExUsbRes7: USB-HSPA Modem: maximal 1 HSPA modem
ExUsbStatus: Status Ihres USB-Ger�tes
ExUsbStorage: USB-Speicher
ExUsbText: Ihre DSL-EasyBox verf�gt �ber einen so genannten USB Host Controller. Dieser USB Host Controller stellt einen USB-Anschluss zur Verf�gung, an den Sie USB-Ger�te anschlie�en und gemeinsam in Ihrem Netzwerk nutzen k�nnen. Ihre DSL-EasyBox eignet sich f�r den Anschluss folgender Ger�te
ExUsbUsage: Nachdem Sie das Ger�t an den USB-Anschluss der DSL-EasyBox angeschlossen haben, klicken Sie bitte auf die Schaltfl�che "Status aktualisieren". Das Ger�t wird oUsagedann in der Tabelle unten angezeigt.
ExUsbUsage1: USB-Massenspeicher mit folgenden Dateisystemen werden unterst�tzt: FAT12, FAT16 und FAT32. Es k�nnen bis zu
ExUsbUsage2: Partitionen zur gleichen Zeit aktiviert werden. Standardm��ig werden die
ExUsbUsage3: ersten Partitionen des USB-Massenspeichers automatisch von Ihrer DSL-EasyBox aktiviert. Wenn Sie mehr als
ExUsbUsage4: bevor
ExUsbUsage5: Partitionen auf Ihrem USB-Massenspeicher konfiguriert haben, deaktivieren bzw. aktivieren Sie die Partition entsprechend Ihren W�nschen. Bitte tun Sie dies
ExUsbUsage6: Sie weitere Einstellungen bei den Men�punkten "Dateiserver", "FTP-Server" und "Web FTP-Server" vornehmen.
ExUsbUsage7: Warnung!
ExUsbUsage8: Wenn Sie Ihren USB-Massenspeicher wieder von der DSL-EasyBox trennen m�chten, klicken Sie bitte unbedingt zuerst auf "Entfernen" in der Tabelle unten! Andernfalls kann es zu Datenverlusten auf dem USB-Massenspeicher oder einem Ausfall des Ger�tes kommen.
ExUsbWebActivate: Einschalten der Funktion Web FTP-Server
ExUsbWebBrowseBrowse: / Durchsuchen
ExUsbWebBrowseHeading: Web-FTP Server / Partition
ExUsbWebHeading: Web FTP-Server
ExUsbWebHost: http://(Host Name)/(URL)
ExUsbWebHostExample: Bsp.: "http://easy.box/dsl_usb2
ExUsbWebHostPort: http://(Host Name):(Port)/(URL)
ExUsbWebHostPortExample: Bsp.: "http://easy.box:8000/dsl_usb2
ExUsbWebIp: http://(IP-Adresse)/(URL)
ExUsbWebIpExample: Bsp.: "http://192.168.2.1/dsl_usb1
ExUsbWebIpPort: http://(IP-Adresse):(Port)/(URL)
ExUsbWebIpPortExample: Bsp.: "http://192.168.2.1:8000/dsl_usb1
ExUsbWebText: Mit dieser Funktion k�nnen Sie Ihren USB-Massenspeicher �ber das HTTP-Protokoll freigeben. Wenn Sie diese Funktion einschalten und alle n�tigen Einstellungen vorgenommen haben, k�nnen Sie aus Ihrem lokalen Netzwerk auf den an der DSL-EasyBox angeschlossenen USB-Massenspeicher zugreifen. Geben Sie hierzu bitte folgende Adresse in Ihrem Internet-Browser ein
ExUsbWebUrl: URL
ExUsbWebUsage: Hinweis: Wenn Sie aus dem Internet auf den USB-Massenspeicher zugreifen m�chten, m�ssen Sie auch die Funktion "Fernzugriff" einschalten. Danach k�nnen Sie auch au�erhalb Ihres Netzwerks auf den USB-Massenspeicher zugreifen, indem Sie eine der oben aufgef�hrten Adressen in Ihrem Internet-Browser eingeben.
HeadingTelephonyAdvance: Erweiterte Einstellungen
HeadingTelephonyAdvanceMicUser: Diese Einstellung erfolgt durch Ihren Anbieter.
HeadingTelephonyCallIn: Eingehende Anrufe
HeadingTelephonyCallLists: Anruflisten
HeadingTelephonyCallOut: Ausgehende Anrufe
HeadingTelephonyCallStates: Status
HeadingTelephonyDialRules: Rufnummernzuordnung
HeadingTelephonyFeature: Telefoneinstellungen
HeadingTelephonyFxo: Rufnummern ISDN/analog
HeadingTelephonyFxo2: ISDN/analog Rufnummer
HeadingTelephonyNewDialRule: Neue Rufnummernzuordnung
HeadingTelephonyNumbers: Rufnummern
HeadingTelephonySip: Rufnummern SIP
HeadingTelephonySip2: SIP Rufnummer
HeadingTelephonyUmts: Rufnummer UMTS
HeadingTelephonyUmts2: UMTS Rufnummer
LblTelephonyActivDetect: Voice Activity Detector
LblTelephonyAdvanceBandwidth: Bandbreitenmanagement
LblTelephonyAdvanceHook: Hook Flash Timer (Millisek.)
LblTelephonyAdvancePmtu: Anpassen PMTU f�r MSI
LblTelephonyAdvancePmtuSize: PMTU Gr��e
LblTelephonyAdvanceRtp: RTP Port
LblTelephonyAdvanceT38: T38 aktivieren
LblTelephonyAlternativNo: Alternative Telefonnummer
LblTelephonyCallIn: Anrufe f�r alle Rufnummern beantworten
LblTelephonyCallOutNote: *Alle Anrufe �ber PSTN/ISDN werden automatisch mit der Preselection-Vorwahl 01070 gef�hrt.
LblTelephonyCallType: Art der Verbindung
LblTelephonyClir: Rufnummernunterdr�ckung (CLIR)
LblTelephonyCw: Anklopfen
LblTelephonyEchoCanc: Echo Canceller
LblTelephonyFirstNo: Erste Telefonnummer
LblTelephonyInband: inband
LblTelephonyIsdnBus: ISDN-Bus
LblTelephonyOutband: outband (RFC 2833)
LblTelephonyPleaseSelect: bitte ausw�hlen
LblTelephonyPreselect: Vorwahl
LblTelephonySipInfo: SIP Info
LblTelephonyTel1: Telefon 1 (F)
LblTelephonyTel2: Telefon 2 (U)
LblTelephonyTel3: Telefon 3 (ISDN)
LblWizardAal5Encaps: AAL5 Encapsulation
LblWizardChannel: Funkkanal
LblWizardConfirmPassword: Kennwortbest�tigung
LblWizardConfirmPw: Kennwort best�tigen
LblWizardDSLPassword: DSL-Kennwort
LblWizardDSLUserName: DSL-Benutzername
LblWizardDhcpEnable: Funktion
LblWizardExpertMode: Expertenmodus
LblWizardFirstIpAddr: Erste IP-Adresse
LblWizardHideSSID: SSID Ausstrahlung
LblWizardIpAddrCount: Anzahl m�glicher IP-Adressen
LblWizardLoginDetails: Internet-Zugangsdaten
LblWizardMicImportantMsg: Diese Installationsvariante sollten Sie nur benutzen, wenn lhr Netzbetreiber Sie dazu auffordert.
LblWizardMicModemInstallCode: Modem-Installationscode
LblWizardMicModemInstallCodeMsg: Bitte geben Sie Ihren pers�nlichen Modem-Installationscode ein. Diesen finden Sie auf der ersten Seite Ihres Willkommensbriefes mit dem Anschalttermin.
LblWizardMicNoHspaModem: Kein HSPA modem gesteckt.
LblWizardMicPersonalPinCodeMsg: Bitte geben Sie Ihren pers�nlichen PIN Code f�r die Mobilfunk SIM-Karte ein. Ihre Verbindung wird dann �ber Mobilfunk hergestellt, wenn keine Festnetz-Verbindung besteht.
LblWizardMicPinCodeSim: PIN Code (f�r SIM Karte)
LblWizardMicStandardInstallation: Standard-Installation
LblWizardMicStorePin: PIN speichern
LblWizardMicUserDefined: Benutzerspezifische Installation
LblWizardNameServer1: Nameserver 1
LblWizardNameServer2: Nameserver 2
LblWizardPassword: Kennwort
LblWizardProtocol: Protokoll
LblWizardSSID: SSID
LblWizardStandardGw: Standard-Gateway
LblWizardStandardInstallation: Benutzerspezifische Schnell-Installation (empfohlen)
LblWizardSubnetMask: Subnetzmaske
LblWizardUserName: Benutzername
LblWizardVoIpAreaCode: Vorwahl
LblWizardVoIpData: Rufnummer Sprach-Passwort
LblWizardVoIpLoginDetails: Sprache (VoIP) –Zugangsdaten (optional)
LblWizardVoIpPhoneNumber1: Rufnummer 1
LblWizardVoIpPhoneNumber2: Rufnummer 2
LblWizardVoIpPhoneNumber3: Rufnummer 3
LblWizardVoIpPwdPhoneNumber1: Passwort Rufnummer 1
LblWizardVoIpPwdPhoneNumber2: Passwort Rufnummer 2
LblWizardVoIpPwdPhoneNumber3: Passwort Rufnummer 3
LblWizardVoiceConfirmPw: Passwort best�tigen
LblWizardVoicePassword: Sprach-Passwort
LblWizardVoiceUserName: Sprach-Benutzername
LblWizardVpiVci: VPI/VCI
LblWizardWlanMode: �bertragungsmodus
NavSubEntryHspaModem: UMTS-Stick
NavSubEntryInternetForwarding: � Spezielle Anwendungen
NavSubEntryIntrusionDetection: � Intrusion Detection
NavSubEntryScheduler: � Regeln f�r Terminpl�ne
NavSubEntryWizard: WIZARD
NavTabEntryDslStandard: � ADSL-Parameter
NavTabEntryQosStatistics: � Statistiken zum Datenverkehr
NavTabEntryQosTrafficPlan: � Datenverkehr zuordnen
NavTabEntryWlanTimer: � Timer
NotYetAvailable: (Feature noch nicht verf�gbar.)
OverviewCurrentTime: Aktuelle Zeit
OverviewDhcpClientLog: DHCP Clientlogbuch
OverviewDhcpClientLogIndex: Anzeige der Informationen zu LAN DHCP-Clients, die Ihrer DSL-EasyBox bekannt sind.
OverviewEventLog: Ereignislogbuch
OverviewEventLogIndex: Anzeige der Ereignisse Ihrer DSL-EasyBox.
OverviewGateway: GATEWAY
OverviewGatewayDhcpServer: DHCP Server
OverviewGatewayFirewall: Firewall
OverviewGatewayIpAddr: IP-Adresse
OverviewGatewaySubnetmask: Subnetzmaske
OverviewGatewayUpnp: UPnP
OverviewGatewayWlan: Wireless
OverviewInfo: INFORMATIONEN
OverviewInfoAdslDisconn: Nicht verbunden
OverviewInfoAdslDriverVersion: ADSL Modemtreiber Version
OverviewInfoAdslEstablished: Verbindung hergestellt
OverviewInfoBootCodeVersion: Boot Code Version
OverviewInfoCountDhcpClients: Anzahl DHCP-Clients
OverviewInfoFwVersion: Firmware Version
OverviewInfoHwVersion: Hardware Version
OverviewInfoLanMacAddr: LAN MAC-Adresse
OverviewInfoSerialNumber: Seriennummer
OverviewInfoWanMacAddr: WAN MAC-Adresse
OverviewInfoWlanMacAddr: Wireless MAC-Adresse
OverviewInternet: INTERNET
OverviewInternetAdsl: ADSL
OverviewInternetDownload: Download
OverviewInternetGateway: Gateway
OverviewInternetMode: Modus
OverviewInternetPrimDns: Prim�rer DNS
OverviewInternetSecDns: Sekund�rer DNS
OverviewInternetSubnetmask: Subnetzmaske
OverviewInternetUpload: Upload
OverviewInternetWanIp: WAN IP
OverviewLanConf: LAN Einstellungen
OverviewLanConfIndex: Sie k�nnen DHCP aktivieren, um IP-Adressen automatisch an die angeschlossenen Clients zu vergeben (dynamische Adressverwaltung) oder um Filterfunktionen - abgestimmt auf spezielle Nutzer oder Protokolle - zu konfigurieren. Der DSL-EasyBox muss eine IP-Adresse f�r das lokale Netzwerk zugewiesen sein.
OverviewLanDhcpParam: Parameter des LAN DHCP Servers
OverviewLanDhcpServer: DHCP Server
OverviewLanDomainName: Dom�nenname
OverviewLanEndIp: Letzte IP des Adresspools
OverviewLanHostName: Host Name
OverviewLanIp: LAN-IP
OverviewLanLeaseTime: G�ltigkeit der IP-Adresszuordnung
OverviewLanLeaseTimeForever: Immer
OverviewLanLeaseTimeHalfDay: Ein halber Tag
OverviewLanLeaseTimeHalfHour: Eine halbe Stunde
OverviewLanLeaseTimeOneDay: Ein Tag
OverviewLanLeaseTimeOneHour: Eine Stunde
OverviewLanLeaseTimeOneWeek: Eine Woche
OverviewLanLeaseTimeTwoDays: Zwei Tage
OverviewLanLeaseTimeTwoHours: Zwei Stunden
OverviewLanLeaseTimeTwoWeeks: Zwei Wochen
OverviewLanStartIp: Erste IP des Adresspools
OverviewLanWlanDhcpParam: Parameter des WLAN DHCP Servers
OverviewLanWlanIp: WLAN-IP
OverviewState: Status
OverviewStateIndex: Verwenden Sie diese Bildschirmanzeige, um den Verbindungsstatus der WAN/LAN-Schnittstellen Ihrer DSL-EasyBox, die Versionsnummern der Firmware und der Hardware, unberechtigte Versuche in Ihr Netzwerk einzudringen sowie Informationen ueber alle DHCP Clients, die gegenw�rtig in Ihrem Netzwerk angeschlossen sind, einzusehen.
OverviewWlanConf: WLAN - Einstellungen
OverviewWlanConfBandwidth: Kanal-Bandbreite
OverviewWlanConfChannel: Funkkanal
OverviewWlanConfExtensionChannel: Zweiter Funkkanal
OverviewWlanConfIndex: Die folgenden Einstellungen zum WLAN Netzwerk k�nnen Sie ver�ndern.
OverviewWlanConfMode: �bertragungsmodus
OverviewWlanConfProtectedMode: Geschuetzter Mode
OverviewWlanConfQos: 802.11e/WMM QoS
OverviewWlanConfSeparateIpLanWlan: Getrennte IP-Adressen fuer LAN und WLAN
OverviewWlanSec: WLAN - Verschl�sselung
OverviewWlanSecAuth: Authentifizierung
OverviewWlanSecDefaultKey: ID des bevorzugten Schl�ssels
OverviewWlanSecDevicePin: WPS-Ger�te PIN (fuer Windows)
OverviewWlanSecDisabled: Ausgeschaltet
OverviewWlanSecEnableWps: Aktivieren von WPS (automatischer Abgleich)
OverviewWlanSecIndex: Die DSL-EasyBox kann die drahtlose �bertragung der Daten verschl�sseln. Hierzu m�ssen Sie auf der DSL-EasyBox und auf den anderen Wireless-Ger�ten die gleichen Verschl�sselungsmethoden einstellen. W�hlen Sie aus der hier aufgef�hrten Liste eine Verschl�sselungsmethode aus und konfigurieren Sie diese an Hand der entsprechenden Felder.
OverviewWlanSecKey: Sicherheitsschl�ssel
OverviewWlanSecKey1: Schl�ssel1
OverviewWlanSecKey2: Schl�ssel2
OverviewWlanSecKey3: Schl�ssel3
OverviewWlanSecKey4: Schl�ssel4
OverviewWlanSecKeyMethod: Art des Schl�ssels
OverviewWlanSecKeyProv: Schl�sselvergabe
OverviewWlanSecMethod: Verschl�sselungsmethode
OverviewWlanSecNasId: NAS-ID
OverviewWlanSecOnlyWPA: Nur WPA
OverviewWlanSecOnlyWPA2: Nur WPA2
OverviewWlanSecPin: WPS-PIN
OverviewWlanSecPskType: Art des Schl�ssels
OverviewWlanSecPskTypeHex: Hex (64 Buchstaben A bis F oder Ziffern)
OverviewWlanSecPskTypePw: Passwort (8 bis 63 Zeichen)
OverviewWlanSecReAuth: Zeitraum bis zur erneuten Authentifizierung
OverviewWlanSecReAuthSec: Sekunden ( 0 steht f�r keine erneute Authentifizierung )
OverviewWlanSecServerIp: Server-IP
OverviewWlanSecServerPort: Server-Port
OverviewWlanSecSessionTimeout: G�ltigkeit
OverviewWlanSecSessionTimeoutSec: Sekunden ( 0 steht f�r unbefristete G�ltigkeit )
OverviewWlanSecWEP: WEP
OverviewWlanSecWPA_WPA2: WPA/WPA2
OverviewWlanSecWaitAuth: Wartezeit
OverviewWlanSecWaitAuthSec: Sekunden nachdem die Authentifizierung fehlgeschlagen ist)
OverviewWlanSecWepMode: WEP Modus
OverviewWlanTimer: WLAN - Timer
OverviewWlanTimerEnd: Ende-Zeit
OverviewWlanTimerFriday: Fr
OverviewWlanTimerIndex: Die DSL-EasyBox erm�glicht Ihnen die WLAN Funktion Timer-gesteuert zu aktivieren.
OverviewWlanTimerMonday: Mo
OverviewWlanTimerSaturday: Sa
OverviewWlanTimerStart: Start-Zeit
OverviewWlanTimerSunday: So
OverviewWlanTimerThursday: Do
OverviewWlanTimerTuesday: Di
OverviewWlanTimerWednesday: Mi
OverviewWlanTimerWeekDay: Wochentage
OverviewWlanTimerWlanEnable: Die WLAN-Funktion wird zu o.g. Zeiten
TextTelephony: Diese Seite enth�lt alle Angaben zum Konfigurieren der Sprach- und Telefoneinstellungen f�r Ihre DSL-EasyBox.
TextTelephonyAdvanceParam: Verschiedene Parameter
TextTelephonyAdvanceRtp: RTP Parameter
TextTelephonyAdvanceT38: T38 Parameter
TextTelephonyAuthId: Auth ID
TextTelephonyAvailableCodecs: Verf�gbare Codecs
TextTelephonyCallInEmpty: Keine eingehenden Anrufe
TextTelephonyCallInList: Eingehende Anrufe
TextTelephonyCallOutEmpty: Keine ausgehenden Anrufe
TextTelephonyCallOutList: Ausgehende Anrufe
TextTelephonyCallStates: Status der Rufnummern
TextTelephonyChangeFxo: Bitte tragen Sie die Rufnummer ohne Vorwahl ein.
TextTelephonyChangeUmts: Bitte tragen Sie die Rufnummer ohne Netz-Vorwahl ein.
TextTelephonyConfirmPassword: Passwort best�tigen
TextTelephonyDisplayName: Angezeigter Name
TextTelephonyDnsSrv: DNS SRV
TextTelephonyDtmf: DTMF Modus
TextTelephonyEnable: Aktiviert
TextTelephonyFailed: Fehlgeschlagen
TextTelephonyFaxPassthroughCodec: FAX Passthrough Codec
TextTelephonyFetchBinding: "Fetch-binding"-Prozedur
TextTelephonyNewDialRule: Die Einstellung der Rufnummernzuordnung wird gespeichert, wenn Sie auf die Schaltfl�che �bernehmen klicken.
TextTelephonyNoAccount: Kein Account aktiviert!
TextTelephonyOutProxy: Abgehender Proxy Server
TextTelephonyOutProxyPort: Abgehender Proxy Port
TextTelephonyPassword: Sprach-Passwort
TextTelephonyPort: Listen Port
TextTelephonyPreselecUmts: Bitte tragen Sie die Netz-Vorwahl (z.B. 0172) ein.
TextTelephonyPreselect: Bitte tragen Sie die Vorwahl ein.
TextTelephonyProxyPort: Proxy Port
TextTelephonyRealm: Realm (Dom�ne)
TextTelephonyRegInterval: Registrierungsintervall
TextTelephonyRegistrar: Registrar Server (Anmeldeserver)
TextTelephonySelectedCodecs: Ausgew�hlte Codecs
TextTelephonySuccess: Erfolgreich
TextTelephonyUseAuthId: Auth ID verwenden
TextTelephonyUseOutProxy: Abgehenden Proxy Server verwenden
TextTelephonyUserName: Sprach-Benutzername
TextTelephonyVc: Listen VC
TextWizardAdslMode: ADSL-Betriebsmodus (WAN)
TextWizardDhcpParam: DHCP Parameter
TextWizardImportant: ACHTUNG
TextWizardImportantMsg: DIESE EINSTELLUNG K�NNEN SIE NUR MIT EINEM FIRMWARE-RESET UNTER VERLUST ALLER EINSTELLUNGEN WIEDER R�CKG�NGIG MACHEN.
TextWizardIspParam: ISP-Parameter
TextWizardStep1: Sie nehmen die DSL-EasyBox zum ersten Mal in Betrieb.
TextWizardStep2: Auf dieser Seite k�nnen Sie die SSID (Name des Funknetzes) und den Funkkanal f�r die drahtlose Verbindung festlegen. Die DSL-EasyBox kann als Basisstation (Access Point) in diesem Funknetz dienen. Die folgenden Parameter werden ben�tigt, um Funkteilnehmer mit der DSL-EasyBox zu verbinden.
TextWizardStep3: Bitte geben Sie Ihre Internetzugangsdaten ein.
TextWizardStep3Voice: Bitte geben Sie Ihre Sprachdaten ein.
TextWizardSummary: Sie haben die folgenden Konfigurationsparameter eingegeben.
TextWizardThanksEasyBox: Danke, dass Sie die DSL-EasyBox gew�hlt haben.
TextWizardWait: Ihre Daten werden gespeichert
WizardMainEntryStep1: Was m�chten Sie tun?
WizardMainEntryStep2: Channel und SSID
WizardMainEntryStep3: Internetzugangsdaten
